A #################################################################################################
        #     # #     #     #   #         # # #           # # #           # #         #       #   #
### ### # ##### # # ##### ### ### ##### # # # # ##### ##### # # ### # ### # # ### # # ### # ##### #
#   #       #   # #   #   #   #   #     #     # #   #   # #       # #   #     # # # #     # # # # #
# ### ### # ### # # ### # # ##### # # ##### # ### # # ### ### # # ### ####### # # ### # ##### # # #
#   #   # #   #   # #   #   # # # # # #   # #   # #   # #     # # # # #         # #   # #   #     #
### ##### # ##### # ####### # # # ### # # ##### # ##### ### ### ### # ### # # ############# ### # #
# #   # # #       # #       #     # #   #   # #       # #   #     # # #   # #     #   #         # #
# # ### ######### ### ### ### ### # # ##### # # ####### ####### ### # # ### ### # ### ######### ###
#     #   # # #       # # #   #   # #   #     # #   # #       # # #   # #   # # # # #   #         #
# ####### # # # ####### # ##### # # ########### ### # ##### ### # ### ### ### ### # ### # ####### #
# # # #         #   #     #   # # #       # #                     # #   #   #     #           #   #
# # # ### ##### ### ####### ####### ##### # # # ##### ### # # ### # # ####### # ##### # # ##### # #
#       #     #       #   #   # #   #   # #   # #     #   # #   # #   #   #   #       # #   #   # #
### ### # # ########### ##### # # ### ### ######### ####### # # ##### # ##### ####### # # ####### #
#   #   # #   #             #   #       # #   #       #     # #   # #     #     # #   # # #   # # #
# # ### ####### # ####### # ### # # # # ##### # ##### ##### ####### ### # ### ### # # ####### # # #
# # #   #   #   # # #     # # # # # # # #       #   #     # #   # #     # # # #     # # # # # # # #
# ######### # ##### # # ### # # ##### # ####### # ######### # ### # ### ### # # # # # # # # # # # #
# #             #   # # #   #       # # # # #     #   # # #   # # #   # #   # # # # # #         # #
# # # ########### ### ### ##### # # ### # # ### ##### # # # ### # ##### # # # # ########### #######
#   #   #   #   #     # #   #   # #   #         #   # # #   # # # # #   # #   #     #     # #     #
### ####### ### ### # # ####### ### ### # ##### # ### # ##### # # # ####### # ### ##### ### # #####
# #     #   #     # #         # #     # # # #   #         #       #         #   #         #   # # #
# # ### # # # # ######### ### ### ### # # # # ##### # ##### ##### ### ######### ####### ### ### # #
# # #     #   #   #   # # #   #     # # #   # #     # #       #     #   # #   #   #   #   # # #   #
# ### ### ### ##### ### # ### # # ### # ### ### ########### ##### # ### # ### ### # ### ### # # ###
# # # #     #   #       # # # # # #   # #     # #       # # # # # # #       # #   #   #   # #     #
# # # ### ### # ####### # # ### ######### ### # ### # ### ### # # ### ### # # ####### # # # ##### #
#     # # # # # #   #             #   # # #         # #   #   #   #   #   # #   #       # #       #
# # ### # # ### ### # ### ##### ### # # ##### # ##### ### # ##### # # ##### # ####### ### # # ### #
# #     # #       #     #   # #     #     # # # #   #   # # #       #   # #       #   # #   #   # #
# ##### ############### ##### ####### # # # ### # ##### # # ### ##### ### # ########### ### ##### #
# #       #   #   #   # # #   #   #   # # # # # #           #       #   #     #   #         #   # #
### # # # # ### ### ### # # # ### # ####### # ####### ### ############# ### ### ##### # # # ### # #
#   # # # #           #   # #   #       #   # #         # #   # #   # #   #   # #   # # # # # # # #
##### ### ### ####### # ##### ### ### ### # # ####### # # ### # # ### # # ### # # ##### # # # # # #
# # #   # #       # #   # # # #     # # # # #   #     # #         #     #   #       #   # # #     #
# # ##### ### ##### ##### # # # # ##### # ### # # ### ########### ### ##### # ##### # ########### #
#   #     # #     #         # # #   #   #     # #   #         # #   #   #   # #     # #   # #     #
# ### # # # ##### # ### # ### ### # ### # ######### ########### ### # ### ### ##### ### ### # ### #
#   # # # #     # # #   #   #   # # #     #     #   #     #   #   # #   #   # #     #     # # #   #
# ### ####### # # # ##### # ### ##### ### # ##### # ### # # ##### ######### ##### # # ### # ### # #
#     #   #   # #       # # #     #   #         # # # # #       #   # # # #   #   # #   #   #   # #
### # ### # ##### ##### ##### # ### ##### ### ####### # ####### ### # # # ### ### # # ### ### ### #
#   #   # #     #     #   # # #         #   # #   #   #     #   #   #           # # # # # #   # # #
# ####### # # ### ######### # ####### ####### # ##### # # ##### ### ### # ####### ### # # ##### # #
#         # #   #             #           # # # #   #   #   #           # # #   #   #   #   #     #
# ### ### ### ######### ### ######### # ### ### # ### ######### # ######### ### ### # ### # ### ###
#   # #   # #     #     #   # #       #   #         # #         # # #           #   #   # # #     #
# ##### ### ### ############# ### ### ### ### ### ##### ##### # ### ### ######### # # ##### ##### #
# #     #     #       # #   #       #   # #   # #   #     # # # #   #       # # # # # # #     #   #
# ######### ##### # ### # # # ##### ##### ### # # # # # ### ### ### ### ### # # ### ### # #########
#         #       # #     # #   #       # #   #   # # #   #         #   #     #   #     #       # #
######### ### # # ##### ####### # ####### ####### ####### # ####### # ########### # ####### ##### #
#   #   # #   # #       #   #   # #     # #   # # # # #   #     #   #   # # #   # # #         #   #
### # # ##### ### ######### ### # # # ### # # # # # # # ##### ### # # ### # ### # ##### ### ##### #
#     # # #     # #     # #   # # # # #     # #         # #   #   #     #         #       #   #   #
### ##### # ##### # # ### # ####### ####### # ### # ##### ### ####### ### ######### ####### # # ###
#       #   #       #             #   #     # #   # #       #   #             # #     #     #   # #
##### ### ##### ####### ####### ##### ### ### # ####### ### ### # ### # # # # # ##### ####### ### #
# #         #     #     #   #     #         #     #       # #   #   # # # # # #     # # #       # #
# # ####### # # # # ##### # ### ### ##### ### ####### ### ######### ### ##### ### ##### # ####### #
#   #       # # # #   #   #           #   # # #   #   # # #     #     # #             #     # #   #
######### # # # # # ####### # ####### ### # ##### # ### # # # ### ##### ##### ####### # ##### ### #
#   # #   # # # # # #   # # #   #   #   #         # #   #   # #   # # # # # #   #   # #         # #
# ### ##### ##### # # ### # ##### # # ####### ##### # # # ### ##### # ### # ####### ### # ### # # #
# #     # #   # # #   # #   #     # #     #         # # #   #           #           # # # #   #   #
# ### # # ##### ### # # # ##### # ####### ### # ### ### ################# ### ### # # ##### #######
# #   #     # #   # #   #     # #     #   #   #   #     #     # #     # # #   # # # #   # # # #   #
# ##### ##### # ##### ####### ### # ##### ### ### ##### # ##### ##### # # # ### ####### # # # ### #
#         #       #       #     # #     # # #   # #         # #           # #   # #         #     #
# ############# ########### ### ### ##### # # ##### # # ### # ### ##### ##### ### # ### # # ### ###
# #         #     #   #   #   # #     #   #     #   # # #     #   # # # #   #     #   # # #     # #
# # ######### ####### # ### ######### ### ##### ### ### # ####### # # # ### ### # # ##### ##### # #
# #       #         #       # #   #   #     #   # #   # # #   #   #       # #   #       #   #     #
# # # ### # ####### ### ### # # ### # # ######### # # # ### ####### ##### # ####### # ##### ##### #
#   #   # # #     #   # #     # # # # #   #   # # # # # #         # #   #       #   #   # # #     #
##### # # ##### # # ### # ##### # # ### # # # # # # ##### # ### # ##### ### ########### # # # ### #
# #   # #   # # # #     #     #     #   # # #   #   #     # #   # # #         #   #   #   # # #   #
# # ######### ### ### # ##### # ### # ####### ### # ### ### ### ### # ##### ### ##### # ####### # #
#       # #     #     # # #     #   #   #     # # #   # # # #       # # #   #     #   # #       # #
### ##### ### # ### ##### ##### ### # # ### ### ### ##### # ### # # # # # ### ### # ### ####### # #
#     #   # # #   #     # # #   #   # #     #     #           # # # # #         #   #       #   # #
# ####### # # # ####### # # # # ### ##### ##### ########### ### ######### ### ########### ##### # #
#     # # #   # #   #       # # #     #       # #   #   # #   #     # # # #   # #       # #     # #
# ### # # ### ### ########### # ####### # ### # # ### # # ### ##### # # # ##### # # ########### ###
# # #   # #     #     #   #   #       # # #         # #   # # #     #             #         #   # #
### ### # # ### # # ### ##### # ### ######### ### ### ##### # ### # ### # ### ### ### ####### ### #
# #   #     #     #   # #   # # #       #   #   # #   #         # #   # # # # #     # #   #       #
# # ### # ############# # # ####### ### # # # ### # # # # ### # ####### # # # ##### ##### ##### ###
# #   # # #   #       # # #       # #   # #   # #   # # #   # #         #   #     #   # #   #   # #
# # # # ### # # ### ### # # ########### # ##### # # # ### # ### ### ### # ##### ### ### # ##### # #
#   #     # #   #   #   # # #   #   #   # #     # # # #   # # # #   # # #   #   #   # #     #   # #
# ### # # ### ##### # # # # # # # # ########### ### # # ##### ### # # ####### # ### # ##### # ### #
#   # # #   #   # #   #   #   #   # # # #   #   #   # #   #   #   #     #   # #   # #             #
##### # ### ### # # ### ####### ### # # # ##### # # ######### ### # # ### ##### # ####### # # # ###
#     #   #       # #     #     #                 #       #       # #     #     #         # # #   
################################################################################################# B
